A.########
#........#
#.###..#.#
#.#....#.#
#.#..#.#.#
####B#####
